[nivel3]
origen=fondomapa3.jpg
cal=32
can=32
mapa= #########################
	  #*!*!*!*!*!*!*!*!*!####*#
	  #%$%$%$%$%#########*!*!##
	  ####!*!*!*!*!###*!*!#%$*#
	  #*!*!###*%$%$###%$%$*!*!#
	  #%$%$######*!###***##***#
	  #*!*!##*!%#%$*!*!#*!*!###
	  #%$%$##%$*##!%$%$#%$%$###
	  #########%$%$######*!####
	  #*!*!####*!*!*!*!##%$#*!#
	  #%$%$######%$%$#####!*!##
	  #*!*!####*!*!*!*!#####*!#
	  #%$%$######%$%$#######*!#
	  ###*#####*!*!*!*!####$%##
	  ###*#####%$%$%$%$###*!###
	  ###%##*!*!####*!*!##%####
	  #*!*!*%$%$####%$%$*!*!*!#
	  #%$%$%############%$%$%$#
	  #########################
	 
	  


[.]
nombre=cesped
px=0
py=0
muro=0

[#]
nombre=infierno
px=5
py=10
muro=1

[*]
nombre=camino1
px=10
py=11
muro=1

[!]
nombre=camino2
px=11
py=11
muro=1

[%]
nombre=camino3
px=10
py=12
muro=1



[$]
nombre=camino4
px=11
py=12
muro=1


[a]
nombre=hojas
px=1
py=5
muro=1




