[nivel]
origen=fondomapa.png
cal=32
can=32
mapa= #########################
	  #.......$...............#
	  #.##########$#########$$#
	  #.#.................#...#
	  #.#........$...-....#...#
	  #.####$#####........$...#
	  #.#........#........#...#
	  #$.........#$############
	  #...-......#............#
	  ############......-.....#
	  #.......................#
	  #$$#########..##$$$######
	  #...........#...........#
	  #.......................#
	  #.......................#
	  #....-##############-...#
	  ###.........$..........$#
	  #**########........###**#
	  #########################
	  


[.]
nombre=cesped
px=0
py=0
muro=0

[#]
nombre=muro
px=12
py=6
muro=1

[*]
nombre=murohojas2
px=6
py=5
muro=1

[$]
nombre=muromovible
px=12
py=4
muro=1

[*]
nombre=puntollegada
px=14
py=4
muro=1

[-]
nombre=hoja
px=6
py=4
muro=1

